wwwwwww
w..c..w
w.....w
w..P..w
w.....w
w..e..w
wwwdwww
   .
   .
   .
   w