wwwwwww
w..c..w
w.....w
w..P..w
w.....w
w.....w
www.www
   .
   E
   .
   w